___S______
__XXXX____
______XX__
XXX_____X_
____XX__XX
__XXXX____
_____XXX_X
X_X_X_X___
___XXX__X_
__XX___G__